107
8
28 4 0 0 0 0 0 0 0 0 0 0 0 0 0 0 0 0 0 0 0 0 3 0 4 18 19 0 0 0 0 0 0 0 0 0 0 0 0 0 0 0 0 3 22 22 22 22 22 22 22 22 22 22 22 22 22 22 22 22 22 22 22 22 22 22 22 22 22 22 22 22 22 22 22 4 0 0 0 0 0 0 0 0 0 0 0 0 0 0 3 22 22 22 22 22 22 22 22 22 22 22 22 22 22 22 22 
28 4 0 0 0 0 0 0 0 0 0 0 0 0 8 0 0 0 0 0 0 0 3 17 4 3 4 0 0 0 0 0 0 0 0 0 0 0 0 0 0 0 0 0 18 22 22 22 22 22 22 22 22 22 22 22 22 22 22 22 19 17 17 17 17 17 17 17 17 17 18 22 22 22 22 4 0 0 0 0 0 0 0 0 0 0 0 0 0 0 0 18 22 22 22 22 28 19 17 17 17 17 17 17 17 18 26 
28 4 0 0 0 17 17 17 0 0 0 0 0 0 14 8 0 0 0 0 0 0 0 0 0 17 17 0 0 0 0 0 0 0 0 0 0 0 0 0 10 11 0 0 0 17 17 17 18 22 22 22 22 22 22 22 22 22 22 22 4 0 0 0 0 0 0 0 0 0 0 17 18 22 22 4 0 0 0 0 0 0 0 0 0 9 0 0 0 0 0 0 18 22 22 22 28 4 0 0 0 0 0 0 0 3 26 
28 4 0 0 19 0 0 0 18 0 0 0 0 10 11 8 0 0 0 0 0 0 0 0 0 0 0 0 0 0 0 0 0 10 11 0 0 0 0 23 24 25 0 0 0 0 0 0 0 17 17 18 22 22 22 22 22 22 22 19 0 0 17 9 17 17 0 0 0 0 0 0 0 17 17 0 0 0 0 9 0 0 0 0 1 24 2 0 0 0 0 0 0 18 22 22 28 4 0 0 0 0 0 0 0 3 26 
28 4 0 0 0 0 0 0 0 0 0 10 11 23 25 8 2 0 0 0 0 0 0 0 0 0 0 0 0 0 0 0 0 23 25 0 0 0 0 26 27 28 0 0 0 9 8 0 0 0 0 0 17 17 17 17 17 17 17 0 0 1 23 24 25 2 0 0 0 0 0 0 0 0 0 0 0 0 0 23 24 25 0 0 8 22 4 0 0 0 0 0 0 0 18 22 28 4 0 0 0 0 0 0 0 3 26 
28 4 0 0 0 0 0 0 0 0 1 23 24 24 24 25 4 0 0 0 0 0 10 11 17 0 0 15 0 0 10 11 0 26 28 0 10 11 0 26 27 28 0 1 23 24 24 25 2 0 17 17 9 0 16 0 0 9 0 0 0 3 26 22 28 4 0 0 0 0 0 0 0 0 0 0 0 0 0 26 27 28 0 0 23 22 8 0 0 0 0 0 0 0 0 17 17 0 0 0 0 0 0 0 0 3 26 
28 4 9 12 10 11 0 0 10 11 13 26 22 27 27 28 4 0 0 0 1 23 24 24 25 2 0 0 9 1 23 24 24 24 24 24 24 25 2 26 27 28 0 3 26 22 22 28 4 10 11 1 24 2 9 0 1 24 2 10 11 23 6 22 28 4 0 0 0 0 0 0 0 9 0 0 23 25 0 26 27 28 9 1 26 27 25 2 10 11 0 0 9 0 0 0 9 0 0 10 11 0 0 9 0 3 26 
28 23 24 24 24 24 24 24 24 24 25 26 22 27 27 28 4 0 0 0 3 26 22 22 28 23 24 24 24 25 26 27 27 27 27 27 27 28 4 26 27 28 0 3 26 27 27 28 24 24 24 24 24 24 24 24 24 24 24 24 24 26 27 27 28 4 0 0 0 0 0 1 23 24 24 24 24 24 24 24 24 24 24 25 26 27 28 23 24 24 24 24 24 24 24 24 24 24 24 24 24 24 24 24 24 25 26 
